#1073	neutral
*********_________********	neutral
@basseuse666	neutral
@deinskysport	neutral
@doccirrus	neutral
@fra	neutral
@lik0n	neutral
@mirkokaminski	neutral
@nichtkatharina	neutral
@ontokki	neutral
@runningtwins	neutral
@ulfheyden	neutral
alimnetz	neutral
altfÃ¼hl	neutral
angenehm	positive
arm	negative
armselig	negative
ausgezeichnet	positive
bahnnewsch	neutral
bartbrudergeburtstag	neutral
bdaslogans	neutral
bedauernswert	negative
besser	positive
biospritt	neutral
bleibtnatÃ¼rlichnichtso	neutral
boxsportâ€‹	neutral
bume	neutral
bÃ¶se	negative
bÃ¼rohilfskrÃ¤fte	neutral
chelst	neutral
deutschst	neutral
druw	neutral
dÃ¼rftig	negative
einerundemit	neutral
einsatzkoordinator	neutral
ekelerregend	negative
ekelhaft	negative
ekelig	negative
ernieundbert	neutral
erungsglas	neutral
falsch	negative
familienausflÃ¼gler	neutral
fies	negative
followeepower	neutral
freundlich	positive
fÃ¼rimmerwaldstadion	neutral
garnichtwitzig	neutral
gebietsvertriebsleiter	neutral
gemein	negative
gemeindenews	neutral
geringwertig	negative
glÃ¼cklich	positive
gomagazin	neutral
gut	positive
handtuchbÃ¼geln	neutral
hrungskr	neutral
hÃ¤sslich	negative
hÃ¶herwertig	positive
hÃ¼bsch	positive
irrig	negative
jobspass	neutral
jweilandnet	neutral
kassakraft	neutral
korrekt	positive
lieb	positive
louisvillecardinals	neutral
mangelhaft	negative
meistgewÃ¼nscht	neutral
mentionsomebodyyouwanttomeet	neutral
minderwertig	negative
misslich	negative
mysmartshop	neutral
nachahmerprodukt	neutral
nachrangig	negative
nativepride	neutral
negativ	negative
nett	positive
ochsenberger	neutral
paload	neutral
positiv	positive
produktinfor	neutral
qualitÃ¤tsverantwortlicher	neutral
rdenfreund	neutral
reaktionskonferenz	neutral
richtig	positive
rstenwald	neutral
sachentscheidu	neutral
sardines	neutral
scheuÃŸlich	negative
schlecht	negative
schlimm	negative
schwach	negative
schÃ¤dlich	negative
schÃ¶n	positive
singoldnetzbote	neutral
solarwÃ¤rmeanlagen	neutral
sooooooommer	neutral
stanzmesser	neutral
stummlarabummsfalleradingdonbananasmelonastuttifruttilp	neutral
systemgegnerin	neutral
tagesblÃ¤ttchen	neutral
technopÃ¤dia	neutral
teil8	neutral
terminadre	neutral
thegym	neutral
twoopies	neutral
unangenehm	negative
unerfreulich	negative
unglÃ¼cklich	negative
ungÃ¼nstig	negative
unrecht	negative
unterlegen	negative
verdorben	negative
versicherungszeitung	neutral
viabuy	neutral
wandbogen	neutral
warghhhh	neutral
widerlich	negative
widerwÃ¤rtig	negative
yijare	neutral
zentrumsleiter	neutral
Ã¼bel	negative
Ã¼berlegen	positive
Ã¼berragend	positive
ã€Œknife	neutral
ã€whistleã€	neutral
é•·åŸ	neutral
ğŸ°	neutral
