#1073	neutral
#1089	neutral
#bertretten	neutral
%user-schwarze-dorn	neutral
*********_________********	neutral
@aalamfaraq	neutral
@basseuse666	neutral
@bobrist	neutral
@continental	neutral
@deinskysport	neutral
@doccirrus	neutral
@fra	neutral
@ilirious	neutral
@lik0n	neutral
@mirkokaminski	neutral
@nichtkatharina	neutral
@ontokki	neutral
@petschi89	neutral
@prinzrupi	neutral
@runningtwins	neutral
@rzkreuznach	neutral
@ulfheyden	neutral
@wildurb	neutral
@youngnova	neutral
aainoh	neutral
aduhhhhh	neutral
akdzqsndh	neutral
alimnetz	neutral
altfÃ¼hl	neutral
amidalai	neutral
angenehm	positive
anscheyunicorn	neutral
arm	negative
armselig	negative
aspargus	neutral
ausgezeichnet	positive
bahnnewsch	neutral
bartbrudergeburtstag	neutral
batteriedienst	neutral
bdaslogans	neutral
bedauernswert	negative
berneri	neutral
besser	positive
binÃ¤rpilot	neutral
biospritt	neutral
bleg	neutral
bleibtnatÃ¼rlichnichtso	neutral
blogtrop	neutral
bodenseepost	neutral
bootydiggers	neutral
boxsportâ€‹	neutral
bume	neutral
bÃ¶se	negative
bÃ¼rohilfskrÃ¤fte	neutral
chelst	neutral
corib	neutral
culturbild	neutral
dangerland	neutral
danztek	neutral
dauersexpartner	neutral
dbrp2013	neutral
demÃ¼ze	neutral
deutschst	neutral
directdate	neutral
dreamyumbra351	neutral
druw	neutral
duskylemon340	neutral
dÃ¼rftig	negative
egotiimes	neutral
einerundemit	neutral
einsatzkoordinator	neutral
eisbohrkern	neutral
ekelerregend	negative
ekelhaft	negative
ekelig	negative
elektronikvertrieb	neutral
energiesparratgeber	neutral
ernieundbert	neutral
erungsglas	neutral
eukalypso	neutral
falsch	negative
familienausflÃ¼gler	neutral
fies	negative
flieeeeegggg	neutral
fokussierer	neutral
followeepower	neutral
followzayn	neutral
frankbergmannist	neutral
freundlich	positive
fridaysong	neutral
frÃ¼hlingÃ¼bersprungen	neutral
ftsf	neutral
fÃ¶rdermittelzeitung	neutral
fÃ¼rimmerreich	neutral
fÃ¼rimmerwaldstadion	neutral
garnichtwitzig	neutral
gebietsvertriebsleiter	neutral
gemein	negative
gemeindenews	neutral
generalagent	neutral
geringwertig	negative
glÃ¼cklich	positive
goalcomnigeria	neutral
gomagazin	neutral
goodã€	neutral
gut	positive
handtuchbÃ¼geln	neutral
hazaaro	neutral
hexenfreunde	neutral
holgie	neutral
hrungskr	neutral
hÃ¤sslich	negative
hÃ¶herwertig	positive
hÃ¼bsch	positive
icheck	neutral
ingeschumann	neutral
intnation	neutral
irrig	negative
iwriter	neutral
jobspass	neutral
jweilandnet	neutral
kalliolle	neutral
kamsha	neutral
kassakraft	neutral
konstruktionstechniker	neutral
korrekt	positive
landespresseg	neutral
leguanartige	neutral
lieb	positive
louisvillecardinals	neutral
madafacka	neutral
mangelhaft	negative
meistgewÃ¼nscht	neutral
mentionsomebodyyouwanttomeet	neutral
millionenã€	neutral
minderwertig	negative
minihamburger	neutral
ministory	neutral
misslich	negative
mwheeee	neutral
myfoodcdaily	neutral
mysmartshop	neutral
mÃ¼mmelnews	neutral
nachahmerprodukt	neutral
nachrangig	negative
nachrichteen	neutral
nailporn	neutral
nasenblÃ¼ten	neutral
nativepride	neutral
naturalienpartei	neutral
negativ	negative
netlikesdeine	neutral
nett	positive
niedlichgÃ¤hn	neutral
noreif	neutral
oberschÃ¤flerinfrÃ¤uleinchen	neutral
ochsenberger	neutral
oniricistas	neutral
otsukaresama	neutral
paload	neutral
polizeikr	neutral
positiv	positive
produktinfor	neutral
pvppussy	neutral
qualitÃ¤tssicherungsfachkraft	neutral
qualitÃ¤tsverantwortlicher	neutral
rdenfreund	neutral
reaktionskonferenz	neutral
rehkopf	neutral
richtig	positive
rstenwald	neutral
sachentscheidu	neutral
samstagstip	neutral
sardines	neutral
scheuÃŸlich	negative
schiiiipuh	neutral
schlecht	negative
schlimm	negative
schwach	negative
schÃ¤dlich	negative
schÃ¶n	positive
singoldnetzbote	neutral
snowyzoner355	neutral
sobbu	neutral
solarwÃ¤rmeanlagen	neutral
sooooooommer	neutral
speditionsleiter	neutral
stanzmesser	neutral
steinpaneele	neutral
steuerassistenten	neutral
strippaaaas	neutral
stripppppers	neutral
stummlarabummsfalleradingdonbananasmelonastuttifruttilp	neutral
suurlÃ¤hettilÃ¤Ã¤t	neutral
sweetpammadison	neutral
systemgegnerin	neutral
tagesblÃ¤ttchen	neutral
technopÃ¤dia	neutral
teil8	neutral
terminadre	neutral
tetran	neutral
thegym	neutral
tippsausnrw	neutral
tixios	neutral
tsuranariau	neutral
tulpensaison	neutral
tumblrmg8dw0fqwr1ry4ouzo1	neutral
turntablefm	neutral
twallen	neutral
tweetchachos	neutral
twoopies	neutral
uitverkorenen	neutral
umbautagebuch	neutral
unangenehm	negative
unerfreulich	negative
unglÃ¼cklich	negative
ungÃ¼nstig	negative
unrecht	negative
unterlegen	negative
ushome	neutral
valentinstagsblumen	neutral
velogistics	neutral
verdorben	negative
versicherungssachbearbeiter	neutral
versicherungszeitung	neutral
versorgungstechniker	neutral
viabuy	neutral
visualsignals	neutral
vovolleyball	neutral
waixershow2	neutral
wandbogen	neutral
warghhhh	neutral
werkseinkÃ¤ufer	neutral
whatafight	neutral
widerlich	negative
widerwÃ¤rtig	negative
wkwostern	neutral
wortdÃ¤monen	neutral
wsuchtwfurm	neutral
yeeeesssss	neutral
yevgen	neutral
yijare	neutral
zentrumsleiter	neutral
Ã¼bel	negative
Ã¼berlegen	positive
Ã¼berragend	positive
âœ¨â­ğŸŒ™â­âœ¨	neutral
ã€Œchristina	neutral
ã€Œdameã€	neutral
ã€Œdj	neutral
ã€Œknife	neutral
ã€12	neutral
ã€glÃ¼ckã€	neutral
ã€whistleã€	neutral
é•·åŸ	neutral
ğŸ°	neutral
