%possmiley33333333333333	positive
%possmileyanke	positive
%possmileyguten	negative
%possmileylg	positive
%possmileysie	positive
&	positive
+1s_	positive
...?	positive
170	negative
36j_	positive
3h_	negative
75c_	positive
:'*	positive
????..	negative
@igippi	positive
aahhhhh	negative
abbl√§ttern	positive
abendlich	negative
abendspaziergang	positive
abgammeln	negative
abi	negative
abk√ºhlen	negative
ablenken	positive
abonnier	negative
abreiben	positive
abschiedsessen	positive
abschlecken	negative
abstechen	negative
abwechseln	negative
adelsblass	positive
adip√∂sen	positive
adoptier	negative
affengeil	negative
ahso	negative
akazienhonig	negative
aladdin	negative
alicia	negative
alihan	positive
alleinsein	negative
allover	positive
allwissend	negative
alsleben	negative
alterego	positive
altfollower	positive
altrosa	positive
amateurfilm	negative
am√ºsierst	negative
analgeilheit	positive
analsp√ºlung	positive
anbr√ºll	negative
angenehm	positive
angezogenes	positive
angst.	positive
anhabe	positive
anh√§ngsel	positive
animateurinnen	positive
anka	negative
ankotzen	positive
annaanal	positive
anne	negative
annehm	negative
annna	positive
anschliessend	negative
anschmei√üen	negative
anstossen.	positive
anstrengst	negative
antanzen	positive
antipasti	positive
antispeziesistisch	positive
an√∂den	positive
apothekenpreise	negative
arbeitsgang	negative
architekturprogramm	positive
arghhh	positive
arianagrande	negative
arkani	negative
arlette	positive
arm	negative
armselig	negative
aromatisch	positive
aronal	negative
arrogante	negative
arschhure	negative
artistin	positive
arvika	negative
as.	negative
askaban	negative
assis.	positive
asti	positive
astrein	negative
atobe	negative
auffallen	negative
aufgabenliste	positive
aufstampfen	negative
aufstellbar	negative
aufzuhaben	negative
aufzuh√ºbschen	negative
augapfel	negative
augenrand	positive
ausgeruhen	negative
ausgest√∂pselt	positive
ausgezeichnet	positive
ausgie	positive
ausladend	negative
ausleeren	positive
ausl√∂ffeln	positive
ausschl√ºrfen	negative
aussenbox	positive
aussenrum	positive
ausstellungsbuch	positive
auswurf	positive
ausw√§rtsfahrern	negative
ausziehen.	negative
auszuckt	negative
authentisch	positive
auto.	positive
autobahnfahrt	positive
autofenster	negative
auuuf	negative
awkward	negative
awrr	positive
ayano	positive
ayden	positive
ayranbart	negative
azkaban	positive
azubine	negative
azzlack	positive
babysch√ºhchen	positive
backblech	positive
backpapier	negative
backpfeifengesicht	negative
badgley	negative
baguettes	positive
bahahaha	negative
ballonseide	negative
bambusrad	negative
bananenpulli	negative
bandnudel	negative
barfa	positive
bart.	positive
bartschatten	negative
basicteil	positive
bastart	positive
basteltisch	negative
bastelworkshop	negative
battlerap	positive
bauchkette	negative
bauchpiercing	positive
bauchtaschen	positive
baumbl√ºte	positive
baumkrone	negative
bayernfan	negative
beachwaves	negative
bedauernswert	negative
bee5	negative
beflei√üen	negative
begl√ºcket	negative
begucken	negative
behindat	negative
behinderter	negative
beifahrer	positive
beileid.	negative
beispiel.	positive
bekippt	negative
bekleidet	negative
belangsendung	negative
bengalkitten	negative
benjoo	negative
benzko	negative
bepusten	negative
bereichernder	positive
berichtsheft	positive
beringten	positive
berlinert	positive
berufspraktisch	negative
beruhigungstropfen	negative
besaiten	positive
besamte	negative
beschwerst	positive
besch√§ftigung	positive
besch√§men	negative
besondere	negative
besondertes	positive
bespannen	negative
bespass	positive
besser	positive
besterlper	positive
besternen	positive
besti	negative
bestimnt	positive
bestimt	positive
betonf√ºssen	positive
betontem	positive
betteln	negative
betthart	negative
betthase83	negative
bewerbungsfoto	negative
be√∂mmelt	negative
bh.	negative
biasliste	negative
biatches	negative
biddesch√∂n	negative
biergarnitur	negative
bieritz	negative
bierpulle	positive
biiiitte	positive
biiitte	positive
bilderkrieg	negative
bildsch√∂nes	negative
billardzimmer	negative
billkaulitz	positive
binden	negative
biobuch	positive
birakta	negative
bises	positive
bissfest	negative
bisshen	negative
bissig	negative
bittesehr	positive
bitt√∂√∂√∂	positive
bizarrlady	negative
blackbook	negative
blaf	negative
blasegirl	positive
blasehasen	negative
blas‚Äô	negative
blattsalat	positive
blauesbluttour	positive
blaus√§urekapseln	positive
blauton	positive
blechdose	positive
blechern	negative
bleibe	negative
blingee	positive
blocken	negative
blondhaarig	negative
blondier	negative
blondierung	positive
blondpussy	negative
blouson	positive
blubbern	positive
blubenkasten	positive
blumenkasten	negative
blumenrock	positive
blumenz√ºchter	negative
blushes	positive
bluten	negative
blutorange	negative
bl√§ser	positive
bl√¥d	positive
bohnenmus	negative
bohr	positive
bombastisch	negative
booaar	positive
boooar	positive
boooom	negative
bork	positive
boulette	negative
bowser	positive
boxen.	negative
boytoy	positive
braarvig	positive
braunt√∂nen	negative
brillenputztuch	negative
brisuren	negative
brotkasten	negative
brotteig	negative
brustbereich	positive
brustbild	positive
bruzzler	positive
br√§tst	positive
btob	negative
buckeln	positive
bud	positive
buddyamateure	negative
budni	positive
buhya	negative
bullenhitze	negative
bumskolben	negative
bundestagskan	negative
buntstiften	negative
burgerladen	negative
burka	positive
busfenster	positive
bussiknuddel	negative
buttergem√ºse	negative
b√§kpo	negative
b√§lleparadies	negative
b√∂ackmailopfer	negative
b√∂se	negative
b√ºchertasche	negative
b√ºgelflasche	positive
b√ºhnenoutfits	negative
b√ºndel	positive
c	negative
ca7	negative
califonia	negative
candice	positive
carportsysteme	positive
catha	negative
catscorner	negative
catsitter	positive
cekirdek	positive
chachacha	positive
chalets	positive
chattest	negative
cheef	negative
cheffe	negative
cheo	negative
chewie	negative
chihuahua	negative
chilene	negative
chinamann	negative
chinchi	negative
chisaiicon	negative
chline	positive
chrakter	positive
chrischan	positive
christbaum	negative
christbaumkugel	positive
ch√∂nnt	negative
cialaska	negative
cimorelli	positive
clausi	positive
clutches	negative
cocktailrausch	positive
commandante	positive
companytour	positive
computerfreak	negative
connichi	negative
cosette	positive
cosplayer	negative
cossen	negative
cousen	positive
cousin.	positive
covern.	positive
crazy	positive
creutzfeld	negative
crunchy	negative
curvefever	negative
cutee	positive
daaaankesch√∂n	negative
dabei.	negative
dad.	negative
daddy.	negative
daigo	negative
danei	negative
dannw	positive
danze	negative
darcy	positive
darf	negative
dascha	positive
dashie	positive
dasitz	negative
dattel	negative
dazustellen	negative
deadhorde	positive
deckr√ºde	positive
deinjanina	positive
demiiiis	positive
dennoch	positive
deppen.	negative
derpriinzz	positive
desinfektionsmittel	positive
deutser	negative
devourment	negative
dezen	positive
diabetologe	positive
dicke	negative
dieine	positive
dieset	negative
dikka	negative
diktatorin	positive
dingerchen	positive
dinosaurierskelette	negative
dippen	positive
discolicht	positive
disko	positive
diskriminierst	positive
disneyfilm	negative
disskutieren	negative
distel	negative
dixi	negative
doch.	positive
doggies	positive
donnerstags	positive
doooooof	negative
dorn	negative
dough	positive
drauf.	negative
draufhauen	negative
dreieck	positive
drescht.	positive
drini	negative
drucki	negative
drunder	negative
dschungelbewohner	negative
dshini	positive
dunkeblonde	negative
dunst	negative
duper	positive
dupstep	positive
durchs	negative
dushe	positive
duz√∂	positive
dwalin	positive
d√§bak	negative
d√§bb	negative
d√§nerys	positive
d√∂nermann	positive
d√∂rt	positive
d√ºrftig	negative
d√ºsseldorfwest	negative
eckzahn	positive
edelstahlarmband	positive
edeltraud	negative
eieeeeeeeeer	positive
eierst√∂cke	positive
einatmen	positive
eine.	negative
einfallen	negative
eingeschnappte	negative
einkeilen	positive
einrichtungs	negative
einsammer	positive
einsch√∂nes	negative
einsp√§nner	positive
einstreu	positive
einwohn	negative
eiscafe	negative
eisschicht	negative
eitag	positive
eitern	negative
ejtzt	positive
ekelerregend	negative
ekelhaft	negative
ekelig	negative
ekina	negative
ektase	positive
elefantenhaken	negative
elegante	positive
elektrisiert	positive
elena	positive
elvis	positive
emailadresse	negative
empfelen	positive
endllich	positive
energielevel	negative
energyzed	negative
engelnyoga	positive
engl√§nder	negative
enkelinchen	negative
enomme	positive
enspannt	negative
entfliegen	positive
entourage	positive
entshuldigen	positive
entsorgungsstelle	negative
eray	negative
erdbeerbaum	positive
erdbeerjoghurt	positive
erdbeerquark	negative
erdbeertorte	positive
erddrache	negative
erdloch	positive
erfreuen	positive
erinnern	negative
erlernba	negative
erm√ºdend	negative
eroddisch	negative
erotikladung	positive
erotikmesse	positive
erotiktreffen	positive
erotisieren	positive
ers	negative
ersmal	positive
ertragbar	negative
ertragen	negative
erwachsenere	positive
erwischen	positive
erzieherhelferin	negative
esmod	positive
esse.	negative
essie	negative
essst√§bchen	positive
estelle	positive
ewarten	negative
ewig	positive
exorzistin	negative
exotonic	positive
experimenttierfreudige	positive
expermentierfreudig	positive
extreeem	positive
eyderboss	negative
eyo	positive
fabse	negative
fabul√∂sen	negative
facebookprofil	negative
fachsimpeln	negative
fakeacc	negative
faken	positive
falafeln	negative
fallschirmsprung	positive
fallste	positive
falsch	negative
fan.	positive
fanarts	negative
farbenblond	negative
farodin	negative
fasr	negative
favo	negative
favoritin	positive
federkiel	positive
federlines	positive
feehan	positive
feierabendlaune	negative
feiertagswetter	negative
fellkn√§uel	positive
fernbeziehung	positive
fernh	positive
fernweh	negative
ferres	negative
fettucine	negative
feucht.	positive
feuerwehrauto	positive
fickfrosch	positive
fickschlitten	negative
fieberblase	negative
fies	negative
filch	positive
filmpr√§mien	positive
filterzigarette	negative
finded	negative
finstre	negative
firmament	positive
firmenfeier	positive
fixies	negative
flachmann	negative
flachwitz	negative
flachwixxer	negative
flanelldecke	positive
flaschenverschluss	negative
flasht	negative
flechte	negative
fledermaus	negative
fleyer	positive
fliegenausreitdecke	positive
flippig	negative
flirtcoach	positive
flitzern	negative
flohmarkt.	positive
fluchderkaribik4	negative
flusspferd	positive
flutschfinger	negative
fl√ºgge	negative
followaz	positive
followerkaufen	negative
followsamislimani	negative
foodblogger	positive
fotofreak	negative
fotostudio	negative
fototapete	positive
frah	negative
franzy	negative
franz√∂sischspiele	positive
frauengeschichte	positive
frauenzimmer	positive
freifuss	positive
frein	positive
freitagsgr√ºsse	negative
freizeittaschen	positive
fresspaket	negative
fressse	positive
freundlich	positive
freundliche	positive
freunlicher	positive
freu‚Äô	positive
frieren.	negative
friesen	negative
frisbeywurf	negative
fritig	positive
fritte	negative
froi	positive
frustessen	negative
frutkoff	negative
fr√§stechnik	negative
fr√∂mpel	positive
fr√ºhlingsbunt	negative
fr√ºhlingsnachmittag	positive
fr√ºhlingsn√§gel	negative
fr√ºhrentner	positive
fr√ºhst√ºckstweet	positive
fusili	positive
fussballaufregung	positive
fussfetischist	negative
futterdose	negative
f√§ngen	negative
f√§rie	negative
f√§sst	positive
f√ºhrungsgeschick	negative
f√ºlbands	negative
f√ºnfziger	negative
f√ºrchterlich	negative
f√ºsseln	positive
gaaaaanze	negative
gaaaay	positive
galamode	positive
gangsta	positive
ganzk√∂rperkontakt	negative
garned	positive
garnit	positive
gartenanlage	negative
gartenf√ºhrer	positive
gassiservice	negative
gatten	negative
gaze	negative
gebruncht	positive
geburtstagssteak	positive
geb√§udetechnikplaner	positive
gedisst	positive
gefauche	positive
gefollowt	negative
gef√§lt	negative
gef√ºhlsecht	positive
gegenst√ºck	positive
gehest	positive
gehirnamputiert	negative
gehirntot	negative
gehpause	negative
geh√§utet	positive
geigenbogen	negative
geiiill	positive
gekomm	positive
gekratzt.	negative
gelangweilt.	negative
geldbeutel	negative
geliked	negative
gemein	negative
gemobbt	positive
generall	positive
genever	negative
gensek	negative
gen√§hter	positive
gepackter	positive
gepupst	negative
gerbera	negative
gereder	positive
geretweetet	negative
geringwertig	negative
germangoogirls	negative
germanys	negative
germanyyy	negative
geschenkanh√§nger	positive
geschenkbox	positive
geschenkchen	negative
geschichtshausaufgaben	positive
geschlappt	negative
geschniegelt	positive
geschnitten.	positive
geschwistertag	positive
gesch√£¬Ñftshaus	negative
gesellschafterin	negative
gesi	positive
gesichtausdruck	negative
gestanden	negative
gestochen.	positive
gestrenge	positive
gesuch	negative
gesundwerd	negative
getellt	positive
getrocknet	positive
gewand	positive
gewimmel	positive
gewisper	positive
gideon	positive
giesskanne	negative
glascabochon	positive
glaskasten	negative
glasteil	positive
glitzernder	positive
glockenblume	negative
glubschi	negative
gl√§serr√ºcken	positive
gl√ºcklich	positive
gl√ºckstr√§ne	negative
gntm.	positive
gogogo	positive
goho	negative
goodgers	positive
googlesuggest	positive
gooooooott	negative
gosche	negative
gouda	positive
grabscht	positive
granatwerfer	negative
grauehaft	negative
grenouille	negative
grille	positive
grillz	positive
gripp	positive
groovige	positive
grossschwanz	negative
gr√ºnt	negative
gr√ºntee	positive
gr√ºnzeugs	negative
gschieder	negative
gsecht	negative
gseht	positive
gst√∂rt	negative
guck.	negative
guhut	positive
guppys	positive
gut	positive
guteeeeee	positive
gutemorgen	positive
gutenachtgeschichte	negative
guterhalten	positive
gutster	positive
gwen	positive
gyros	negative
g√§stef√ºhrerin	negative
g√∂schenen	negative
g√ºldenes	negative
g√ºtzli	positive
haara	negative
habanera	positive
habem	negative
hacke	negative
hackfleisch	negative
hahaaaaa	negative
hahahahq	positive
haikus	positive
hakle	negative
halbling	positive
halskratzen	positive
hamburger.	positive
hammerstimme	negative
hammertollen	negative
hamsterbacken	negative
hanbyul	positive
handgelenk	positive
handr√ºcken	negative
handschellen	negative
handynummer.	negative
hanswurst	negative
hardrock	positive
harleyfahrer	positive
harmonie.	negative
harpune	positive
hatsune	positive
hauchst	negative
hauptact	positive
hauptstrasse	negative
hausbesichtigung	positive
hauseingang	negative
hausmutti	negative
hazuki	positive
heatte	negative
heftig.	positive
hegnau	negative
heibe	positive
heida	negative
heil	positive
heilerdemaske	positive
heimkinovergn√ºgen	positive
heir	negative
helge	positive
hellblau	negative
hemdchen	positive
heme	negative
hemngslos	negative
henckels	positive
herablassend	negative
herack	negative
herrenmagazin	positive
herrensalon	negative
herumtollend	negative
herzelein	positive
herzensw√§rme	positive
herzerweichend	positive
herzfreundin	positive
herzf√∂rmiger	negative
herzlein	negative
herzlichkeit	negative
hideaways	negative
hief	negative
hierher	negative
hife	positive
higheels	positive
hihihihihi	negative
hinauf	positive
hinfahrt	positive
hingehn.	positive
hinte	negative
hintendran.	negative
hintereingang	positive
hinterfotzigen	negative
hinterher	negative
hipsterkind	negative
hitzeschock	negative
hmhmhmmm	negative
hmmm	positive
hochheb	positive
hochtalentiert	positive
hochzeits	positive
hochzeitstaugliche	positive
hofgartenstrasse	negative
holts	positive
holzbeinen	positive
holzperlenarmband	negative
holzstapel	negative
hooooot	positive
hormon	negative
hormone.	negative
hotelpool	negative
huii	positive
huiiii	negative
hundehotels	negative
hundepfoten	positive
hundetraining	positive
hundine	positive
hurensch√∂n	negative
huut	negative
h√§lmchen	negative
h√§misch	negative
h√§ngebr√ºsten	positive
h√§ngerchen	positive
h√§rzlich	positive
h√§sschen	positive
h√§sslich	negative
h√§√§√§	negative
h√∂chstpers√∂nlich	positive
h√∂herwertig	positive
h√∂rerinnentreffen	negative
h√ºbsch	positive
h√ºftlang	positive
h√ºpschen	positive
h√ºrchen	positive
ichat	negative
ich‚Äôs	negative
ihrm	positive
ijemand	negative
illustratorin	negative
imne	positive
impekoven	negative
inen	negative
ingwertee	negative
inne	negative
innenbox	positive
instagrammfilter	positive
intellktuell	positive
intensiv	negative
interessant	positive
internet.	positive
irdendwann	negative
irrenhaus	positive
irrig	negative
isst.	negative
iss‚Äôn	negative
ivoire	positive
iwi	positive
ja2	negative
jaaay	positive
jackett	positive
jahrmarkt	negative
jahrmarkt.	positive
jedenfals	positive
jenne	negative
jerry	negative
jessica	positive
jeute	positive
jeztz	negative
jimbo	positive
jippi	negative
jiyongie	negative
jogi	positive
johansson	negative
jorel	positive
jugenderinnerung	negative
juhuu	positive
juicy	positive
jumpen	positive
jungenhaft	negative
jungfer	negative
j√§gerhut	positive
j√§hrlings	positive
j√∂√∂√∂	negative
j√∂√∂√∂√∂√∂	negative
j√ºdin	negative
k0mmentare	negative
kabbeln	positive
kackend	positive
kadsen	positive
kaffeeknopf	negative
kagg	positive
kaimane	negative
kakashi	negative
kakuzu	negative
kalli	negative
kalorienarm	negative
kamerad	negative
kamikater	positive
kaminromantik	negative
kannt	negative
karneol	negative
kartenlegerin	positive
kartoffelkiste	positive
karusell	positive
kasperl	positive
katzenfressnapf	positive
katzenhaaren	negative
kautz	negative
kehlenfick	positive
keksfabrik	negative
keldeo	positive
kemperhof	negative
kennengelernt.	positive
keramikpfannen	negative
kiez	negative
kinderchor	positive
kindergartenkind	negative
kindergesicht	negative
kindheitstrauma	positive
kinnschutz	positive
kirschroter	negative
klarlack	positive
klauenseuche	negative
klebestreifen	negative
kleckere	negative
kleinbleibenden	negative
kleinkariert	positive
kliene	positive
klinge	negative
klischeehaft	negative
klit	positive
klitzekleines	positive
kloppis	positive
klops	positive
knabstrupper	negative
knacks	negative
knatschen	negative
knautschen	positive
knick	positive
knieenden	negative
kniesocken	positive
knoblauchbrot	negative
knospen	negative
knuffische	positive
kn√§ul	negative
kn√ºpf	negative
kochkurs	negative
kochvergn√ºgen	negative
koku	negative
kokusnuss	negative
kollegial	negative
kommulitonen	negative
kommuniziern	negative
komparse	positive
konoha	negative
konservendose	negative
kontaktbild	negative
kontaktdaten	negative
kopfh√∂hrer	negative
korbsessel	positive
korrekt	positive
kosmetiktaschen	negative
kotzfresse	negative
krach	positive
kramst	positive
krangh	positive
kreiseln	negative
kreissaal	positive
kricht	positive
kriechen	positive
kriegsgewinnler	positive
krisknapp	positive
kristallkugel	negative
krok√ºsse	positive
kr√ºmmeltee	negative
kr√ºmmen	positive
kuche	negative
kuchenkr√ºmel	negative
kufatec	negative
kulturbanausen	positive
kuppeln	positive
kurokocchi	negative
kurzname	positive
kuschelhasen	negative
kuschelsack	negative
kuschligsten	positive
kussecht	positive
kutcher	negative
kutter	negative
kwanghee	negative
kwangmin	negative
k√§lteempfindlich	positive
k√§mmst	positive
k√§mpfend	negative
k√§seigel	negative
k√ºbel	positive
k√ºchenkraut	negative
k√ºchenstuhl	negative
k–≥—òhlschrank	negative
laaaaangsam	negative
lachsfilet	negative
lacken	positive
lackstiefel	negative
lady.	negative
lallend	negative
lana.	negative
lang.	positive
langa	negative
langarmshirt	positive
lannisters	negative
larp	negative
lastpic	negative
latino	negative
lattemacchiato	positive
laufsachen	positive
laufsch	negative
lauscherlounge	negative
lavigne	negative
leatherface	negative
lebendig	positive
lebendigkeit	negative
lebenseinkommen	negative
lebensf	negative
lebertran	positive
lecki	negative
lede	negative
lederhalsb√§nder	negative
ledersohle	positive
legging	positive
legokiste	negative
leguanfarm	negative
lehne	negative
lehrerpaar	negative
leichtrittig	positive
leichtsinnig	positive
leidenschaft	positive
leiwand	negative
lena18	negative
lenkergewicht	positive
leo	negative
lesbenporno	positive
leuchtend	negative
lgds	positive
liche	positive
licht	negative
lichtdurchflutet	negative
lichtquelle	positive
lico	negative
lieb	positive
liebeb	positive
liebesbeziehung	negative
liebesgeschichte	negative
lieblin	positive
lieblingsaccount	negative
lieblingsband	positive
lieblingscafe	negative
lieblingsecke	negative
lieblingskombi	positive
lieblingsm√§dchen	positive
lieblingspaar	negative
lieblingsserien	positive
lieblingsspielerin	negative
lieblingssportar	positive
lieblingsstecher	negative
lieblingsstelle	positive
lieblingsstellung	positive
lieeeeeeebe	positive
ligacup	negative
liiiiiiiieeebe	positive
lilla	negative
limetten	negative
linksh√§nderin	positive
linsensalat	negative
lippestift	positive
lochi	negative
loch|l√∂chern	negative
loggia	positive
loggst	negative
loljongun	negative
loller	negative
longus	positive
luftgitarre	negative
lufttrocknen	positive
luise	negative
lulle	negative
lustloch	positive
lustobjekt	negative
luststab	negative
l√§ngenvergleich	positive
l√§sternde	positive
l√∂chlein	negative
l√∂wenkopf	positive
l√ºckenf√ºller	negative
maaag	positive
macchina	positive
macheath	negative
machomann	negative
macken	negative
madln	negative
maite	positive
mally	negative
maloche	negative
maltr√§tieren	positive
mandelf√∂rmige	positive
mangelhaft	negative
manik√ºrt	positive
manniboy	positive
mappe	negative
marmeladenbr√∂tchen	positive
marmorstein	positive
marsupilamie	positive
marzipanei	negative
masturbierend	negative
mathegenie	positive
mathematischh	positive
matheo	negative
matrosinnen	positive
matsche	negative
maul	negative
mauzen	negative
maxe	negative
mayo	positive
medls	positive
meeresbrise	negative
megaaaaaa	positive
megaheiss	positive
megaorgasmus	positive
megaschlecht	positive
meikel	negative
melanzani	negative
melisa	negative
melitta	positive
melkfett	positive
menchu	negative
menki	positive
menschenmenge	positive
menschentiereunddoktoren	negative
metallfresse	negative
miasat	negative
mibewohnerin	negative
mikro	negative
milchtopf	negative
minderwertig	negative
mindfucked	negative
minidisplay	positive
minimi	positive
minori	positive
mintgr√ºne	negative
min√ºtchen	positive
mipm	positive
mirgen	negative
misaka	negative
missgeburten	positive
misslich	negative
mistig	negative
mitleidend	negative
mitleser	positive
mitmarschieren	positive
mitreiterin	negative
mitschi	positive
mitschleppen	positive
mitsch√ºlerin	positive
mittagsgruss	negative
mittelalt	positive
mittelm√§√üiger	positive
mittvierziger	positive
mlp	negative
mobilfriseur	negative
modeln	positive
mohrenkopf	negative
mollis	positive
montag.	positive
moppelchen	positive
moppers	positive
mopsgeschwindigkeit	positive
morgenlatten	negative
motivier	positive
motzanfall	negative
muahahahha	positive
muddah	positive
muddu	positive
muffe	negative
muhahahahah	negative
mukena	negative
munchkin	positive
muschi.	negative
musicbase	negative
musicpark	negative
musst.	negative
myrte	negative
m√§nnerklamotte	negative
m√§nnerschw√§nze	negative
m√∂wengeschrei	positive
m√∂ws	negative
m√∂√∂p	negative
m√ºllen	negative
m√ºnschen	negative
m√ºsssen	negative
n'aww	negative
nachbarplatz	positive
nachf√§rben	negative
nachrangig	negative
nachschenken	positive
nachtitweet	positive
nachzufaven	negative
nackenkissen	negative
nackenklatscher	negative
nackenpolster	negative
nackenschmerz	negative
nacktsein	negative
naildesigns	negative
namensschild	positive
naschkatze	positive
natasha	negative
naturdarm	negative
naturnagelverst√§rkung	negative
naturn√§gel	negative
naziaufkleber	positive
nciht	positive
neeeeeeein	negative
negativ	negative
neglige	positive
neidiesch	positive
neidischsten	positive
neonorange	negative
nerft	negative
nervstimme	negative
netrebko	negative
nett	positive
nette.	negative
netzabsturz	negative
netzh√∂schen	positive
neufundl√§nder	negative
nices	positive
nicks	positive
nid	positive
nihi	negative
nihihi	positive
nikol√§use	negative
nimmst.	positive
nischt	negative
njaa	negative
noaaaar	negative
noaaw	negative
noona	positive
noriko	negative
normandie	negative
nostril	negative
notenblatt	positive
notfallspray	negative
noverryirawan	negative
nulpen	positive
nume	negative
nuno	negative
nuppel	negative
nuscheln	negative
nussknacker	negative
nutten.	negative
n√§herst	negative
n√§xt	negative
n√∂cher	negative
n√∂gschte	negative
n√∂len	negative
n√∂√∂√∂√∂√∂√∂	positive
n√ºssler	positive
oahr	positive
oasch	positive
obdachloser	positive
obendrauf	positive
oberhonnefeld	positive
oberlippenbart	positive
obermieter	negative
oberrohr	negative
obieglo	negative
odins	positive
ohhhhhhhh	negative
ohmann	negative
ohringe	positive
okayichh√§ttedasoideen	positive
okkkk	positive
oldschool	negative
onedirection	negative
onkelgordy	negative
ooohhh	negative
oooooooooh	positive
oppas	negative
ornanieren	negative
oshima	positive
osternest	negative
otzen	positive
outgun	positive
padawane	negative
paddel	negative
paheli	positive
pairing	negative
panache	negative
pandab√§rchen	negative
pantel	positive
pappig	positive
parodierst	positive
parteeyy	negative
partyraum	positive
partyschlampe	positive
partytop	negative
pectoralis	negative
pedantisch	positive
pello	positive
penisse	negative
peperoni	positive
peppeln	negative
pergament	negative
pewds	negative
pfandflaschen	positive
pfeifchen	positive
pfeifenraucher	positive
pferdekopf	positive
pferden	positive
pflanzk√ºbel	positive
pflegebeteiligung	positive
pflegehund	positive
phantasialand	negative
phielib	positive
ph√§	negative
pics	positive
pieeeep	positive
pieren	positive
pilotenbrille	negative
pilsken	negative
pimmels	negative
pingui	positive
pinselchen	negative
pintomix	negative
pippi	positive
pixies	negative
pll.	negative
pl√§uschen	negative
pl√∂tzlech	negative
pl√ºschiges	negative
podcatcher	negative
podenca	positive
poge	negative
pokemons	negative
pooh	positive
poppen	positive
porzellanpuppe	positive
positiv	positive
postamt	negative
postboten	positive
postbotin	negative
posterwand	positive
pottwal	positive
praxisschild	positive
preisinger	positive
probiers	negative
profie	negative
profikoch	positive
propellerflugzeug	positive
proud	positive
pr√∂m	positive
psychologin	positive
psychom√§ssig	negative
pumpdildo	positive
punkig	negative
puush	positive
p√∂rtgenherder	positive
quark	positive
rafa	negative
raku	positive
ramazotti	positive
ramontik	negative
rappen	negative
rassestute	positive
rastplatz	negative
rasul	positive
ratte	positive
rattenscharfe	positive
ratze	negative
raucherbank	negative
raumakzente	negative
rauschentfernung	positive
rausgegangen.	negative
rausmusste	positive
ravioli.	positive
rawk	positive
reapern	positive
rebecka	negative
reblogge	negative
rechtschreibschw√§che	positive
rechtzei	positive
redheads	positive
regg√§	negative
regtop	negative
reinbeisst	positive
reinfahren	positive
reinknieen	positive
reinkommen	negative
reinschiebe	positive
reintunken	positive
reiseangebot	positive
reisendiashow	negative
reiskocher	positive
reissverschluss	positive
remoulade	positive
renke	positive
renov.	positive
rhetorikhammer	negative
richtig	positive
riechend	negative
riesendanke	negative
ring.	negative
risige	positive
rittersporn	positive
robs	negative
rocke	positive
rogate	negative
rojinski	negative
roki	negative
rolator	negative
rolf.	negative
rom.	negative
romantikerinnen	negative
rooz	positive
rosaner	positive
rose	negative
ros√®	positive
rothmann	positive
rotstich	negative
rotweinkuchen	positive
rted	negative
rtst	positive
ruckzuck	negative
rumgehen	positive
rumgehurt	positive
rumlecken	negative
rumsauen.	negative
rumschleimst	negative
rumspacken	negative
rumtanzen	negative
rumtrampeln	negative
rumtreiben	positive
runffm	negative
runna	positive
runter	negative
runterspringen	negative
runterz√§hlen	negative
r√§kelnde	positive
r√∂hrenjean	negative
r√∂stkartoffel	positive
r√∂stung	negative
r√ºhrkuchen	positive
sahneklecks	negative
saju	positive
salamibrote	negative
samantha	positive
saminatorgeschichte	negative
sammlerpuppe	positive
sanduhr	negative
sango	negative
sangria	positive
sarahann	negative
saraya	positive
saruhiko	positive
sascha	positive
sasori	negative
satinbettw√§sche	negative
sauber.	negative
saunabesuch	positive
saunakota	negative
sazzy	positive
schaben	positive
schabernackig	negative
schalalala	negative
schatze	positive
schatzo	negative
scheisseeeeee	negative
scheu	negative
scheu√ülich	negative
schickeria	negative
schiebs	positive
schienst	negative
schippchen	positive
schlacksi	positive
schlafwandeln	positive
schlagzeug	positive
schlangeneier	positive
schlecht	negative
schlimm	negative
schluchzen	negative
schluckgieriges	negative
schlumperb√ºx	positive
schl√§mpchen	negative
schl√∂n	negative
schl√ºsselanh√§nger	negative
schmalzen	positive
schmalzstulle	positive
schmatz	positive
schmeckst	negative
schminktutorial	negative
schmucknadeln	negative
schmusehund	negative
schm√∂kere	positive
schnackt	negative
schneewei√üer	negative
schneits	positive
schnelsten	positive
schnibben	positive
schnidde	negative
schnippseln	positive
schnorres	positive
schnuffelig	negative
schnullerbacke	positive
schnupfig	positive
schnuppi	positive
schoffer	positive
schokoh√§schen	negative
schokoladiger	negative
schokosplittern	negative
schoneinmal	negative
schonste	positive
schrade	negative
schramme	negative
schreck	positive
schroff	positive
schrottkiste	negative
schuhmarke	negative
schuluni	positive
schutzengelbild	negative
schwabenl√§ndle	negative
schwach	negative
schwanztr√§ger	negative
schwarzbier	negative
schwarzbrot	positive
schweinsfilet	negative
schwei√ü	positive
schwerg√§ngig	negative
schwiegermutters	positive
schwin	negative
schwipp	positive
schwulenpornos	positive
schwungvoll	negative
schw√§nze	positive
schw√§rze	positive
schw√∂rma	positive
sch√§dlich	negative
sch√§hm	positive
sch√§lst	negative
sch√µne	positive
sch√∂n	positive
sch√ºl	negative
scotch	positive
sedona	positive
sehnsuchtsadressen	negative
seintje	positive
sekttrinken	negative
selbstgef√ºhl	negative
selbstgezeichneten	negative
selbstzweifelnd	positive
seltsam	negative
sentimental.	negative
sepia	positive
serenas	positive
sers	positive
sevi	negative
sevil	negative
sfx	negative
shanks	positive
shaq	positive
shatz	negative
sheba	negative
shemale	positive
shemales	positive
shindong	negative
shou	negative
shoutout	positive
shwester	positive
sica	positive
sichst	positive
siemensmitarbeiterin	negative
siemst	negative
sie|sie	negative
silikonform	negative
silvity	positive
singha	positive
singleportal	positive
sis.	positive
sisch	negative
sitzende	negative
sj√∂	positive
skikurs	positive
sklavenschwanz	negative
skypen.	positive
sleigher	positive
slushy	positive
snapbacks	positive
sobst	negative
softes	negative
sohappy	positive
sommerparty	negative
sommersocken	negative
sonderbonbons	negative
sonnelicht	negative
sonnenreichen	negative
sonnenstich	negative
sonore	positive
sooooooooooooooooooooooo	positive
sooss	positive
sozialevolont√§r	positive
sozialromantikhintergrund	negative
spalt	negative
spammercommunity	positive
spargelcremesuppe	negative
spazier	positive
speculum	positive
spellyournamewithrammsteinsongs	negative
spiegelbrille	positive
spiegelfotos	positive
spiiieeeellll	negative
spitzenstoff	negative
spliff	positive
splittern	positive
spn	negative
spok	positive
spongbob	negative
spongebozz	positive
sprachmemo	negative
sprachs	negative
sprechstimme	positive
springbrunnen	negative
stachelschwein	negative
stadessen	positive
stallgemeinschaft	negative
standhaft.	positive
standst	positive
stangentanz	negative
stanze|stanzen	negative
starbucksverk√§ufer	negative
staskowiak	positive
staub.	negative
staubf√§nger	negative
stehenlassen	negative
steiinoptik	positive
stengel	positive
sterben	positive
sternchenverteiler	positive
stiefdad	positive
stiefelabsatz	negative
stilikonen	negative
stillkissen	positive
stimmfang	positive
stimmungsschwankung	negative
stockschirme	negative
stoffhose	negative
stotterst	negative
straciatella	positive
strassenband	positive
streitlustig	negative
strickliese	positive
strick|stricken	negative
stubenrocker	negative
stuie	negative
sturmmaske	positive
stute.	positive
styla	positive
st√∂rrisch	negative
suffie	negative
suhlen	negative
superfan	negative
surferboys	positive
surp	negative
surreal	negative
sushi.	negative
suspektesten	positive
svend	positive
svene	negative
swaghetti	positive
sweeett	positive
sweetdesire	positive
swiet	positive
s√§chsil√º√ºte	negative
s√§nger	negative
s√ºdl√§ndisch	negative
s√ºffig	negative
s√ºse	positive
s√ºz	negative
s√º√º√ºsss	positive
tabaluga	positive
tabby	positive
tachchen	positive
tafelwerk	negative
taff	positive
tagebart	negative
tagesrhythmus	negative
tagsforlikes	negative
tammara29	negative
tanu	negative
tanzst	positive
tanzstudenten	positive
tanztraining	positive
tapezierarbeit	positive
tarnklamotte	positive
taschenaschenbecher	positive
taschenuhr	negative
tattop	negative
tauchbecken	negative
taxifahrer	negative
teamtea	positive
teebaum√∂l	positive
teeglas	positive
teeniefreundin	positive
teenygirl	positive
teier	negative
teigfladen	negative
telefoieren	positive
tenimyu	positive
tennie	positive
teppat	positive
teppich.	positive
terrassent√ºr	negative
textnachrichten	positive
thail√§nderin	negative
theaterp√§dagogin	positive
thefaculty	negative
thehidden	negative
theredcubetv	negative
thermalbad	positive
thommy	positive
timberlands	positive
tischgebet	negative
tittenava	negative
tittenmassage	positive
tobsuchtsanfall	positive
tockner	negative
tollige	positive
tonstudio	negative
torchwood	positive
totknuddeln	positive
totkrank	positive
tourgeschenk	negative
trainingsanzug	positive
trainingspartnerin	negative
trannen	positive
trashig	negative
trashiger	negative
trashnight	negative
trashtazmani	negative
traumschuhe	positive
trebs	positive
trekkingtour	positive
tret	negative
trocknen	positive
trocknungsger√§t	negative
trolololol	positive
trotzdem.	positive
troya	positive
troztem	negative
trulle	positive
trz.	negative
tr√ºb	negative
tschuldige	positive
tsch√º√º√ºs	negative
tute|tuten	negative
tvtotal	negative
twink	positive
twitterabstinent	negative
twitterbar	positive
twitterrunde	negative
tws	negative
typie	negative
tzz	negative
t√∂len	positive
t√ºrramen	positive
ubd	positive
ukelele	positive
ullmann	positive
umarmt	negative
umgekleidet	negative
umgerannt	positive
umschnalldildos	positive
unaktiv	negative
unangenehm	negative
unbescholte	positive
unbeschreiblich.	negative
uneigenn√ºtzig	positive
uneinsichtig	positive
unerfreulich	negative
unfallambulanz	positive
unfollowen	negative
ungelogen	negative
ungeziefer	negative
ungezogen	positive
ungl√ºcklich	negative
ung√ºnstig	negative
unikat	negative
universalmedizin	positive
unkpomplizierte	negative
unrecht	negative
unterholz	positive
unterh√∂schen	negative
unterlegen	negative
unvollkommenheit	negative
unwiderstehli	positive
unwissend	negative
urinieren	positive
urlaubsende	negative
urlaubsort	positive
urlaubsziel	negative
uuuuunglaublich	negative
vaginas	negative
valldemossa	positive
vanilleschote	positive
vanillezucker	negative
vegetarierin	positive
velut	positive
vendola	negative
verabscheuen	negative
verbittern	positive
verblichen	positive
verdirb	positive
verdorben	negative
verf√ºhrun	negative
verhauen	positive
verh√ºlt	negative
verkauffe	positive
verkopfter	positive
verliehrt	negative
vernunftbegabt	negative
vern√ºftigen	positive
verpartnern	positive
verpennen	negative
verr√ºcktesachenmachenwennmanverliebtist	negative
verschisse	positive
verschw√∂rungstweet	positive
versicherungstyp	positive
verslein	positive
versprechs	positive
verst√∂re	negative
vertilg	positive
vertrauensvoll	negative
verweilen	positive
verw√∂hnprogramm	negative
verzehrst	negative
verzichte.	negative
verziehn	positive
verziere	negative
ver√§ppelt	negative
videooo	negative
videowunsch	positive
viedo	negative
vieeeeele	positive
vieeeele	negative
vika	positive
visagistic	positive
vladimir	negative
vogelnest	positive
voher	positive
vollblut	negative
vollgeil	positive
vollgewichst	negative
vollkommen	positive
vollstopfen	positive
volltrottel	positive
vorahnung	negative
vorbeiziehen	positive
vorgl√ºhen	positive
vorhut	negative
vorkochen	positive
vornehmt	negative
vortanzen	negative
voyeur	negative
vr100	negative
vreni	negative
waaaaah	positive
waaaah	positive
wackelpudding	positive
waffenschein	negative
wahlkabinen.	positive
walther	negative
wannebe	positive
warlander	negative
waschbecken	negative
waschsalon	positive
wassern	positive
waxing	negative
we	positive
webcamfotos	positive
webdesignerin	negative
wecker	positive
weger	positive
weggeboxt	positive
weggefeiert	negative
weggehn	negative
weibsbild	negative
weinende	negative
weinkeller	positive
weintest	negative
weissbauch	positive
weissesr	negative
weiteer	negative
weitergepennt	positive
weiterschicken	positive
wellensitische	positive
welpenfotos	negative
wennigstens	positive
wenn‚Äôs	negative
werbayernm√ºnchenmag	positive
werbebude	positive
werbegeschenk	negative
werdest	positive
wertsch√§tzt	negative
wetterunabh√§ngig	positive
wettr	negative
wgds	positive
whatsappnachrichten	negative
whatwhat	positive
whoa	negative
wichtig	positive
wichtiig	positive
wickeltuch	positive
widerlich	negative
widerspenstig	positive
widerw√§rtig	negative
wievielt	negative
wigwam	negative
wild.	positive
wilden.	negative
winterm√ºde	negative
winzermeister	negative
winzigkeit	negative
wirsch	negative
wixe	negative
wneig	negative
wochenede	positive
wochenendeende	positive
woggy	positive
wohaa	positive
wohns	negative
wohnug	negative
woistolivia	negative
wolke.	positive
wolkenfreier	negative
wollt.	positive
wolten	positive
wommy	positive
wonderwall	negative
woodkid	negative
wordpressseite	negative
wortgewandtheit	negative
wulli	positive
wundercreme	negative
wunderherrlichen	positive
wundersch√∂ner	negative
wundesch√∂n	negative
wundesch√∂ner	positive
wunschhalsband	positive
wunschoutfit	negative
wunschsongs	negative
w√§√§	positive
w√§√§√§h	positive
w√ºndersch√∂nen	positive
w√ºnscg	negative
w√ºnsh	positive
w√ºrschtel	negative
x215cm	negative
x3333	positive
x333333	negative
yagma	positive
yeahhhhhhhh	positive
ylva	positive
yongguks	positive
yuppies	negative
yuri	negative
y√º√§√§r	positive
zackzack	negative
zahnstange	negative
zahn√§rzten	positive
zayns	negative
zazabrooklyn	positive
zdz	positive
zehensocken	positive
zeichentrickfigur	positive
zelten	positive
zerfickt	negative
zerst	positive
zerteil	positive
zeuch	negative
zickende	positive
ziegenb√§rtchen	negative
zigarettenrauch	positive
zigarreten	positive
zimmerboy	negative
zimmerwand	positive
zimt.	negative
zitronencreme	positive
zm√ºed	negative
zockst	positive
zombieaugen	negative
zubei√üen	negative
zuckst	positive
zudr√∂hnen	negative
zugekniffen	negative
zuha	negative
zulenken	positive
zupfer	negative
zureiten	positive
zurennt	negative
zur√ºckgr√º√üen	positive
zusammen.	negative
zusammenschmeisst	positive
zuspamt	positive
zuvergessen	negative
zuverl√§ssi	negative
zvv√§ggg	negative
zweitwohnung	positive
zweizimmerwohnung	negative
zwergdackelwelpen	positive
zwick	negative
zwiebelmett	negative
zwitschernd	positive
zwulf	positive
zw√§ngen	positive
z√§mme	positive
z√ºrichsee	negative
¬∞¬∞	negative
√§lt	negative
√§rmellos	negative
√§√§hh	positive
√ßay	positive
√ºbel	negative
√ºberfliegst	negative
√ºberfressen	positive
√ºberlegen	positive
√ºberlegs	positive
√ºbernacht	positive
√ºberra	negative
√ºberragend	positive
√ºtendorf	negative
⁄ì◊≤	negative
‚Äòdigga‚Äô	negative
‚ô•lich	positive
‚ô•‚ô°‚ô•‚ô°	negative
‚ùÑ‚õÑ	negative
üéÄ	positive
üëó	positive
üíá	positive
